1111111111111111
1E00000000C00101
1010000100100101
1010100100100101
1P00C000000001C1
1111111111111111
