1111111111110
10010000000C1
1000011111001
1P0011E000001
0111111111111
