1111111111111
1E00000C00101
1001100100101
1P0C0000001C1
1111111111111
