1111111111111
1C00C000000C1
1000P11110001
100011E0000C1
1111111111111