11111111111111111111111
1C000000000C100C0000001
10000P00000010000000E01
10111111111010001111111
10000C00C000100000001C1
100C0000000011111100101
100111111111100C0000101
100000000C00000010000C1
11111111111111111111111