11111111111111111111111111111111111111
1P00001111100000111111E000000000000001
100000111110000C11111100000000C0000001
10000011111000001111110000000000000001
10000C1111100000111111111111110000C001
10000011111000001111111111111000000011
10000011111000001111111111110000000111
1000000000000C001111111111100000001111
100C0000000000001111111111000000011111
10000000000000001111111110000000111111
111111111110000011111111000C0001111111
11111111111000001111111000000011111111
11111111111000001111110000000111111111
111111111110C00011111100000000000000C1
1111111111100000111111000C000000000001
11111111111000001111110000000000000001
10000000C000000000000000000000C0000001
10111111111111111111111111111111111111
100000000000000000000C0000000000000001
111111111111111111111111111111111111C1
11111111111111111111111111111111111111