1111111111111
1C0000C0001C1
100000P00E011
1111111111111