11111111111111111111111
10000000000010000000001
100000P0000010000000E01
10111111111010001111111
10000000000010000200001
10000000000011111100001
10011111111110000000001
10000020000000001000001
11111111111111111111111