11111111111111111111111
10000000000010000000001
100000P0000010000000E01
10000000000000000000001
10000000000000000000001
10000000000000000000001
10000000000000000000001
1000000000000000P000001
11111111111111111111111