1111111111111111111111111111
1111111111111111111111111111
1111001110011110000000001111
1111001110011110C11111001111
1111001110C11111111100011111
1111000000011111110001111111
1111000000011111000111111111
1111111110011110011111111111
1111111110011110C00000001111
1111111110011110000000001111
1111111111011111111111101111
11000000C000000000P000000111
1100000000000E00000000000111
1111111111111111111111111111
1111111111111111111111111111
1111111111111111111111111111